############################################################
#           #              #   #          #              # #
#         # #              # #                             #
#         # #              #          #         #       #  #
#         # #              #  #                            #
#         # #              #       #     #       #         #
#         #                   #                        #   #
#         ################## #       #            ##       #
#         #                #         #    #                #
#         ##    #          ##     #              #    #    #
#         #  #        #    #                    #          #
#         #       ###### # #           #              ##   #
#             # ###        #    #   #        #    #  #     #
#                 #        # #      #             #  #     #
###################  #######              #          #     #
#                 #        #################################
#                 #        #                               #
### # ### # # # #########                                  #
#     #         #     # #                                  #
#   # #  #         #  # ################################## #
#     #       #    #  #   #                                #
#   # #            #  # # #                                #
#   # #   #     #  #    #                                  #
############################################################
